Map Count 3
Map No 0
Array row&column 11 11
Entrance Position 1 1
Export Position 9 9
1 1 1 1 1 1 1 1 1 1 1
1 0 1 0 0 0 0 0 1 0 1
1 1 0 0 0 1 1 0 0 1 1
1 0 1 1 1 1 1 1 1 1 1
1 0 1 0 0 0 0 1 0 0 1
1 0 1 0 0 1 1 0 0 0 1
1 0 1 1 0 0 1 1 0 0 1
1 1 0 1 0 0 1 1 1 0 1
1 1 1 0 0 1 1 0 1 1 1
1 0 0 0 1 0 0 1 0 0 1
1 1 1 1 1 1 1 1 1 1 1

Map No 1
Array row&column 5 5
Entrance Position 1 1
Export Position 3 3
1 1 1 1 1
1 0 0 0 1
1 0 1 1 1
1 0 1 0 1
1 1 1 1 1

Map No 2
Array row&column 14 17
Entrance Position 1 1
Export Position 12 15
1	1	1	1	1	1	1	1	1	1	1	1	1	1	1	1	1
1	0	1	0	0	0	1	1	0	0	0	1	1	1	1	1	1
1	1	0	0	0	1	1	0	1	1	1	0	0	1	1	1	1
1	0	1	1	0	0	0	0	1	1	1	1	0	0	1	1	1
1	1	1	0	1	1	1	1	0	1	1	0	1	1	0	0	1
1	1	1	0	1	0	0	1	0	1	1	1	1	1	1	1	1
1	0	0	1	1	0	1	1	1	0	1	0	0	1	0	1	1
1	0	0	1	1	0	1	1	1	0	1	0	0	1	0	1	1
1	0	1	1	1	1	0	0	1	1	1	1	1	1	1	1	1
1	0	0	1	1	0	1	1	0	1	1	1	1	1	0	1	1
1	1	1	0	0	0	1	1	0	1	1	0	0	0	0	0	1
1	0	0	1	1	1	1	1	0	0	0	1	1	1	1	0	1
1	0	1	0	0	1	1	1	1	1	0	1	1	1	1	0	1
1	1	1	1	1	1	1	1	1	1	1	1	1	1	1	1	1